R  800 500


NO     textures/wall_1.xpm
 SO  textures/wall_2.xpm
WE  textures/wall_3.xpm
 EA textures/wall_4.xpm
S   textures/sprite_1.xpm
 F 64,43, 21
C  100    ,    198,227


 11111111 1111111 1111111111111
 1110000010000001100000001    11111111
1000000000000000002000001     1      1
1000000000000000000000001     11111111
1110000000110000000000001111111
  100000000000000000000001111111
11100111000001001000000010001
11100111000001001000010010001
11000000000200200000000000001
10002002000002002000000010001
10000000020100000000000000001
110000011101010111000010W01111
11000011 1000101 101000000001
11111111 1111111 111111111111